
    NO    textures/Wall_NO1.xpm

SO textures/Wall_SO1.xpm           
WE textures/Wall_WE1.xpm


C     221,198,255

EA textures/Wall_EA1.xpm

F 12,33,255             




         111111111111111111   
 100001  1011010000000000001
1000N1   0010 SWEN  010000001
11110111111111111111111111111
11111111 1111111111   11111111
11