
               NO    textures/Wall_NO1.xpm


SO                              textures/Wall_SO1.xpm
WE textures/Wall_WE1.xpm


C     51,198,227
F 184,1y3,39
EA textures/Wall_EA1.xpm



1111111111111
     1000000000001
1000000000001
1000000000E0011
111111111111101
             11