NO ./textures/wood_green.png
SO ./textures/wood_yellow.png
WE ./textures/wood_red.png
EA ./textures/wood_blue.png
C 171,219,245
F 117,98,75



1111111111111111111111111111111111111111
1000000000001111100011111000000000000001
10E0000000001000000000001000000000000001
1000010000001000000000001000000100000001
1000010000001000000000001000000100000001
1000000000001000000000001000000000000001
1111110111110000000000001111110111111111
1000000000000000000000000000000000000001
100000000000000000000000000000000000001
1000000000000001000000001000000000000001
1000000000000001000000001000000000000001
1000000000000000000000000000000000000001
1000000000000000000000000000000000000001
1111110111110000000000001111110111111111
1000000000001000000000001000000000000001
1000010000001000000000001000000100000001
1000010000001000000000001000000100000001
1000000000001000000000001000000000000001
1000000000001111100011111000000000000001
1111111111111111111111111111111111111111