NO ./textures/brick_n.png
SO ./textures/brick_s.png
WE ./textures/brick_w.png
EA ./textures/brick_e.png

F 184,113,39
C 51,198,227



11111111111111111111111111111
100001  101101000000000000001
1000N1  100100000001010000001
11111111111111111111111111111
11111111111111111111111111111
