NO ./textures/brick_n.png
SO ./textures/brick_s.png
WE ./textures/brick_w.png
EA ./textures/brick_e.png

F 184,113,39
C 51,198,227

        1111111111111111111111111
        1000000000110000000000001
        1011000001110000000000001
        100101111111111100000000111111
11111111101101101110001111111111
1000000000110111111011111111111
1111011111111111111111111111111
111101111111111111111111010001
11000001111101011100000010001
1000001     10001100000010001
1000001     10001101010010001
11000001111101011111011110N0111
11110011111010111101111010001
11111111111111111111111111111