NO ./textures/wood_green.png
SO ./textures/wood_yellow.png
WE ./textures/wood_red.png
EA ./textures/wood_blue.png
C 51,198,227
F 117,98,75



11111111111111111111111111111
10000000001100000000S00000001
10110000111000000000000000111
1001000000000000000000000001
111111111011000011100000001
100000000011000001110111111111111
11110111111111111000000010001
1111011111111111101010010001
11000000110101111100000010001111
10000000000000101100000010001
10000000000000111010100100001
11111111111111111111111111111
11110111 1110101 101111010001
11111111 1111111 111111111111