NO ./textures/brick_n.png
SO ./textures/brick_s.png
WE ./textures/brick_w.png
EA ./textures/brick_e.png

F 184,113,39
C 51,198,227

 111
1N01
1111
