NO textures/Wall_NO.xpm
SO textures/Wall_SO.xpm
WE textures/Wall_WE.xpm
EA textures/Wall_EA.xpm

F 184,113,39
C 51,198,227


1111
1N01
1111
