

NO ./textures/brick_n.png
SO ./textures/brick_s.png
WE ./textures/brick_w.png
EA ./textures/brick_e.png


    C 171,219,245
F 117,98,75

1111111111111111111111111111
1000000000110000000000000001
101100001110000000000000001
1001000000000000000000000001
111111111011000011100000001
100000000011000001110111111111111
11110111111111111000000010001
1111011111111111101010010001
11000000110101N11100000010001111
10000000000000001100000010001
10000000000000011010100100001
11111111111111111111111111111
11110111 1110101 101111010001
11111111 1111111 111111111111