NO ./textures/wood_green.png
SO ./textures/wood_yellow.png
WE ./textures/wood_red.png
EA ./textures/wood_blue.png
C 51,198,227
F 117,98,75

11111111111111111111111111111
10000000001100S00000000000001
10110000011100000001111011111
11111111110000000000000000011111
        10110000011100000000000111111
        100000000110000011111111111
11111111111111011100000010001
11110111111111011101010010001
11000000110101011100000010001
11111111000000001100000010001
       10000000000000001100011111111
    11110000110101000000000011111
11111111110101000000000000001
10000000001100000100000010001
10000000000000000000000001001
10000000111100010000000001001
100000001  100110101110000001
10000000111110000001 10100001
11111111111111111111 11111111
