NO ./textures/brick_n.png
SO ./textures/brick_s.png
WE ./textures/brick_w.png
EA ./textures/brick_e.png

F 184,113,39
C 51,198,227


1111111111111
1000000000001
1000000000001
1000000000E0011
111111111111101
             11
