

NO ./textures/brick_n.png
SO ./textures/brick_s.png
WE ./textures/brick_w.png
EA ./textures/brick_e.png

C 221,198,255
F 12,33,255             






111111111111111111111111111111
1000011  101101000000000000001
1000001  101011010000001111111
111101011000000000111111111111
111101110000S0000000011111111
111111111111111111111111111111   