
NO ./textures/wall_no.xpm
WE ./textures/wall_we.xpm
SO ./textures/wall_so.xpm
EA ./textures/wall_ea.xpm

F 11,12,2
C 135,206,245

 1111111111111111111111
1000000000000000000001
 1000000000000000000001
  10000000000000000001
   100000111111000001
    1000001  1000001
     10001111110001
      100000000001
       1000000001
        10000001
         100101
          1E01
           11