



NO     ./textures/wall_no.xpm
WE ./textures/wall_we.xpm
SO ./textures/wall_so.xpm
                    EA ./textures/wall_ea.xpm

       F 111,12,2
C 35,206,215

 1111111111111111111111
10000000000000000000001
 1000000000000000000001
  10000000011000000001
   100000111111000001
    1000000001000001
     10001111110001
      100001100001
       1000000001
        10000001
         100001
          1001
          1S1
           1
