



NO     ./textures/wall_no.xpm
WE ./textures/wall_we.xpm
SO ./textures/wall_so.xpm
                    EA ./textures/wall_ea.xpm

       F 111,12,2
C 135,206,215

 1111111111111111111111
100000000000000000000001
 1000000000000000000001
  10000000000000000001
   100000111111000001
    10000010N10000001
     100011111100011
      100000000001
       1000000001
        10000001
         100101
          1001
           11
           1
