EA textures/Wall_EA.xpm
SO textures/Wall_SO.xpm
WE textures/Wall_WE.xpm
NO textures/Wall_NO.xpm
C 51,198,257
F 1a4,113,39

11111111111111111
111S0000111111111
11100001000011111
11110000011111111
11111011111111111
    101
    101
1111001
100001
 11101
11110111
10000001
10011101
101  101
10111001
1000001
1111111