NO textures/Pac-Man/Ghosts/K/ghost_right1.xpm
SO textures/Pac-Man/Ghosts/R/ghost_right2.xpm
EA textures/Pac-Man/Ghosts/G/ghost_right3.xpm
WE textures/Pac-Man/Ghosts/B/ghost_right4.xpm

F 0,0,23
C 0,5,0

11111111111111111111111111
11111101000000000010111111
11111101011111111010111111
10000000010000001000000001
11111101011111111010111111
11111101000000000010111111
11111101011111111010111111
10000000000011000000000001
10111101111011011110111101
1000110000000E000000110001
11111111111111111111111111
